222220122222
222220000002
222200022002
055202022022
000003002322
200202000022
222200022322
222222222002
222250000002
222222222222
222222222222
222222222222
